1111111111111111111111111111111111
1E0000000000000C00000C000000000001
1010010100100000101001000000010101
1010010010101010001001000000010101
1P0000000C00C0000000000000000000C1
110000000110000D00000C000000D00001
1100000001100000000000000000000001
1100000001111001000001111100000001
1C000D000000000100000C000000000001
1111111111111111111111111111111111